#################
#...#...#...#..E#
#.#.#.#.#.#.....#
#.#.#.#.#.#.###.#
#...............#
#.#########.#####
#S..............#
#################